[pygments.styles]
andromeeda = pygments_styles.andromeeda:AndromeedaStyle
aurora-x = pygments_styles.aurora_x:AuroraXStyle
ayu-dark = pygments_styles.ayu_dark:AyuDarkStyle
ayu-light = pygments_styles.ayu_light:AyuLightStyle
ayu-mirage = pygments_styles.ayu_mirage:AyuMirageStyle
catppuccin-frappe = pygments_styles.catppuccin_frappe:CatppuccinFrappeStyle
catppuccin-latte = pygments_styles.catppuccin_latte:CatppuccinLatteStyle
catppuccin-macchiato = pygments_styles.catppuccin_macchiato:CatppuccinMacchiatoStyle
catppuccin-mocha = pygments_styles.catppuccin_mocha:CatppuccinMochaStyle
dark-plus = pygments_styles.dark_plus:DarkPlusStyle
everforest-dark = pygments_styles.everforest_dark:EverforestDarkStyle
everforest-light = pygments_styles.everforest_light:EverforestLightStyle
github-dark-default = pygments_styles.github_dark_default:GitHubDarkDefaultStyle
github-dark-dimmed = pygments_styles.github_dark_dimmed:GitHubDarkDimmedStyle
github-dark-high-contrast = pygments_styles.github_dark_high_contrast:GitHubDarkHighContrastStyle
github-light-default = pygments_styles.github_light_default:GitHubLightDefaultStyle
github-light-high-contrast = pygments_styles.github_light_high_contrast:GitHubLightHighContrastStyle
gruvbox-dark-hard = pygments_styles.gruvbox_dark_hard:GruvboxDarkHardStyle
gruvbox-dark-medium = pygments_styles.gruvbox_dark_medium:GruvboxDarkMediumStyle
gruvbox-dark-soft = pygments_styles.gruvbox_dark_soft:GruvboxDarkSoftStyle
gruvbox-light-hard = pygments_styles.gruvbox_light_hard:GruvboxLightHardStyle
gruvbox-light-medium = pygments_styles.gruvbox_light_medium:GruvboxLightMediumStyle
gruvbox-light-soft = pygments_styles.gruvbox_light_soft:GruvboxLightSoftStyle
laserwave = pygments_styles.laserwave:LaserwaveStyle
laserwave-high-contrast = pygments_styles.laserwave_high_contrast:LaserwaveHighContrastStyle
light-plus = pygments_styles.light_plus:LightPlusStyle
min-dark = pygments_styles.min_dark:MinDarkStyle
min-light = pygments_styles.min_light:MinLightStyle
one-dark-pro = pygments_styles.one_dark_pro:OneDarkProStyle
one-light = pygments_styles.one_light:OneLightStyle
plastic = pygments_styles.plastic:PlasticStyle
